"filename", "language", "Java", "Markdown", "Draw.io", "comment", "blank", "total"
"f:\Cours\Java\PulseCoaching\README.md", "Markdown", 0, 1, 0, 0, 0, 1
"f:\Cours\Java\PulseCoaching\diagramme_classes.drawio", "Draw.io", 0, 0, 247, 0, 1, 248
"f:\Cours\Java\PulseCoaching\src\main\com\pulsecoaching\Main.java", "Java", 244, 0, 0, 12, 36, 292
"f:\Cours\Java\PulseCoaching\src\main\com\pulsecoaching\exception\Equipe\EntraineurDejaDansUneEquipeException.java", "Java", 6, 0, 0, 6, 4, 16
"f:\Cours\Java\PulseCoaching\src\main\com\pulsecoaching\exception\Equipe\EntraineurNonPresentDansEquipeException.java", "Java", 6, 0, 0, 6, 4, 16
"f:\Cours\Java\PulseCoaching\src\main\com\pulsecoaching\exception\Equipe\EquipeDejaAUnEntraineurException.java", "Java", 6, 0, 0, 6, 4, 16
"f:\Cours\Java\PulseCoaching\src\main\com\pulsecoaching\exception\Equipe\EquipeSansEntraineurException.java", "Java", 6, 0, 0, 6, 4, 16
"f:\Cours\Java\PulseCoaching\src\main\com\pulsecoaching\exception\Equipe\EquipeSansJoueurException.java", "Java", 6, 0, 0, 6, 4, 16
"f:\Cours\Java\PulseCoaching\src\main\com\pulsecoaching\exception\Equipe\JoueurDejaDansUneEquipeException.java", "Java", 6, 0, 0, 6, 4, 16
"f:\Cours\Java\PulseCoaching\src\main\com\pulsecoaching\exception\Equipe\JoueurNonPresentDansEquipeException.java", "Java", 6, 0, 0, 6, 4, 16
"f:\Cours\Java\PulseCoaching\src\main\com\pulsecoaching\exception\Joueur\JoueurGardienAvecAutresPositionsException.java", "Java", 6, 0, 0, 6, 4, 16
"f:\Cours\Java\PulseCoaching\src\main\com\pulsecoaching\exception\Joueur\JoueurSansPositionException.java", "Java", 6, 0, 0, 6, 4, 16
"f:\Cours\Java\PulseCoaching\src\main\com\pulsecoaching\exception\Joueur\JoueurTropDePositionsException.java", "Java", 6, 0, 0, 6, 4, 16
"f:\Cours\Java\PulseCoaching\src\main\com\pulsecoaching\exception\Joueur\PourcentageInvalideException.java", "Java", 6, 0, 0, 6, 4, 16
"f:\Cours\Java\PulseCoaching\src\main\com\pulsecoaching\interfaces\Entrenable.java", "Java", 7, 0, 0, 29, 6, 42
"f:\Cours\Java\PulseCoaching\src\main\com\pulsecoaching\model\Blessure.java", "Java", 32, 0, 0, 37, 18, 87
"f:\Cours\Java\PulseCoaching\src\main\com\pulsecoaching\model\Entrainement.java", "Java", 68, 0, 0, 40, 23, 131
"f:\Cours\Java\PulseCoaching\src\main\com\pulsecoaching\model\Entraineur.java", "Java", 71, 0, 0, 34, 28, 133
"f:\Cours\Java\PulseCoaching\src\main\com\pulsecoaching\model\Equipe.java", "Java", 302, 0, 0, 161, 91, 554
"f:\Cours\Java\PulseCoaching\src\main\com\pulsecoaching\model\Joueur.java", "Java", 177, 0, 0, 107, 58, 342
"f:\Cours\Java\PulseCoaching\src\main\com\pulsecoaching\model\Match.java", "Java", 76, 0, 0, 44, 26, 146
"f:\Cours\Java\PulseCoaching\src\main\com\pulsecoaching\model\Personne.java", "Java", 40, 0, 0, 17, 17, 74
"f:\Cours\Java\PulseCoaching\src\main\com\pulsecoaching\model\Position.java", "Java", 26, 0, 0, 21, 14, 61
"f:\Cours\Java\PulseCoaching\src\main\com\pulsecoaching\model\TypeBlessure.java", "Java", 23, 0, 0, 13, 9, 45
"f:\Cours\Java\PulseCoaching\src\test\com\pulsecoaching\model\BlessureTest.java", "Java", 28, 0, 0, 24, 13, 65
"f:\Cours\Java\PulseCoaching\src\test\com\pulsecoaching\model\EntrainementTest.java", "Java", 51, 0, 0, 20, 14, 85
"f:\Cours\Java\PulseCoaching\src\test\com\pulsecoaching\model\EntraineurTest.java", "Java", 24, 0, 0, 12, 4, 40
"f:\Cours\Java\PulseCoaching\src\test\com\pulsecoaching\model\EquipeTest.java", "Java", 147, 0, 0, 115, 49, 311
"f:\Cours\Java\PulseCoaching\src\test\com\pulsecoaching\model\JoueurTest.java", "Java", 117, 0, 0, 96, 36, 249
"f:\Cours\Java\PulseCoaching\src\test\com\pulsecoaching\model\MatchTest.java", "Java", 53, 0, 0, 19, 9, 81
"Total", "-", 1552, 1, 247, 867, 496, 3163